###################
#      O#        O#
#    ####   P     #
#    ####         #
#     X #        X#############
#                            O#
#                             #
#                      X      #
#                             #
###############################